For	Rev
AGGGGTAGTAAGGTTTGAATGAGAA	CCTAATATTTAACCCAAAACCACCT
GATTATTTTTGGGAGGGGTAGTAAG	AACCCAAAACCACCTCTAACTCTAC
GTTTAGTGGATTTGGGAAGGGTAT	AAAAACATCCTTAAAAACCAACTCC
TTTGTATTTTAGGAAGGTTTTGTGA	AAAATCAAACCAACTCCAATCCTA
TTTTAGTTATTTGGGAGGTTGAGGT	CCCTTCACCCTTTTAATCCTAAC
TTTGGGTGATAGAGAGATTTTGTTT	CAAATCACAAAACCTTCCTAAAATA
GTTATTGTTTGGAAATTTTATGGGG	CAAATCCCCTAAAAAAATAATCACC
AAATTTAGGATTGGTGTGGTTAGTG	CCCAAAAACAAAAAATTCAAAAATA
TTGGTGATTATTTTTTTAGGGGATT	AAACCTTCTCCAAAATCACAAATTC
GAATTTGTGATTTTGGAGAAGGTTT	CTCTCAATCTTTTACTTCCACTCCA
GGTTTTGGAGTGGAAGTAAAAGATT	AAAAAAAATTTCCCCAAAATCACTA
TGGAGTGGAAGTAAAAGATTGAGAG	AAAAAAAATTTCCCCAAAATCACTA
TAGTGATTTTGGGGAAATTTTTTTT	TTCACAAAACCCTAAAACTTACAC
GTGTAAGTTTTAGGGTTTTGTGAA	ACCAAAACTACTTACTCCCAAACAA
TGTTTGGGAGTAAGTAGTTTTGGTT	CCCAACCCTCTAAAACTCTCC
TATTTTTATTTTATGGATGGGGGAG	CCTATCTAATCCCAACAAAACTCCT
GGGTATGTTGGTATGGTAGGA	CAAAATCCCTAAAACTAACATCTTTC
TTTTTTTTGTTTTGGATATTTTGGA	AATCCCTAAAACTAACATCTTTCCC
GGGAAAGATGTTAGTTTTAGGGATT	AACCTCCTCTCTACCTCTATCCAAA
TGGAGATTTTTGGTAAGATGTAAGG	AAATTTTCATCACCTTTATCCCAAC
GGATTTGGATAGAGGTAGAGAGGAG	CCCCCATCCATAAAATAAAAATAAT
TTGGATAGAGGTAGAGAGGAGGTTT	CTCCCCCATCCATAAAATAAAAATA
GTTAAGGGTTGGGATAAAGGTGAT	CCTATCTAATCCCAACAAAACTCCT
ATTTAATTGTTAATTGGGATTGGGT	CTAAACCTCTAACCCTCCAAAAAAC
ATTTAATTGTTAATTGGGATTGGGT	ATAACCTAAACCTCTAACCCTCCAA
TTGGAGGGTTAGAGGTTTAGGTTAT	TTAAAATAAAATTCCCTTTCCCATC
TTAAAATAGGTTTTTAGGGTTTGGG	AAAAAATAATATCCTCTTACCCTTTACAA
GTTTAGGGGAATGGTGTTTTTTTGT	ATCTTAATACAATAATCCTACCCCC
GGAATGGTGTTTTTTTGTTTTTTAT	ATCTTAATACAATAATCCTACCCCC
TTTTTAGGGTTGTGTTTTTTTTAGA	CCCCTTTCCCTATCTAATCCTAATA
TATTAGGATTAGATAGGGAAAGGGG	CTCCCTAAAAAATCAAAAACTCAAA
TATTAGGATTAGATAGGGAAAGGGG	CAACAAAAATCCTACTAAAATCAAACA
TTAATAGTTGAGTTTGGGGAGTTTG	AAACAACATCATTAACATCACCTCC
GATAGGGTTTTTGGAGTTGGTATTT	CACCACAAAATTTCTTTCTCTATCC
GGTTTTTGGAGTTGGTATTTTTTTT	CCTCCCCAACTTCACTTAACAAC
GTTAAGTGAAGTTGGGGAGGG	CTCAATTACATCCCCAAATCTAAAA
TTTTAGATTTGGGGATGTAATTGAG	TCTATCACCAACTCACAATAACCCT
TTTAGGGTTATTGTGAGTTGGTGAT	ATACCTAAAACCACCAAAATTTCCA
GAGGTTAGTAAGAGGTTTGGAGAGG	ACCTTAAATTCAAACCAAACAAACA
TGTTTGTTTGGTTTGAATTTAAGGT	AATTTCTCCTCCTCTTCCTACTCCT
AATTTTTTTATTAAAGTGTTGGGGG	TCTTTAAAATTTTCACATTCCCTTC
GAAGGGAATGTGAAAATTTTAAAGAA	AACCCAAAAAACAAAAATTACACAA
GGAGGTGATGTTAATGATGTTGTTT	AAAAAAAATACCAACTCCAAAAACC
TGTTATTTATGTTGGAGTGTAGTGG	TATAATCCCAACACTTTAAAAAACC
GTTTTGGTTTTTGTGAAGAGGTTG	ACCTTCCCACCTTAATAACACCTAA
TTTTTTTAAGTAGGGTGGTGAGAGT	AAAAAAACAACCTAAAAAACATCCC
AATTTTAGTATTTTGGGAGGTTAAGG	CAAACAATTCTCCTAAATCAACTTCC
GTTTGGTTAGGATTTTGGGGG	AAACCTCTAAAACAAAATCTCCCCT
